#######===
#  T  ####
#XCO PP  #
#%###O##O#
#   P  #P#  
#B     # #
#    #   #
#  C#  T # 
#E M#  S #
##########